XXXXXXXXXXXXXXXXXXXXXXXXX
X                 X     X
X XXXXXXXXX X X X X X X X
X         X X X X X X X X
X XXXXXXX X X X X X X X X
X X       X X X X X X X X
X X XXXXX X X X X   X X X
X X X S   X X X X X X X X
X X           X X X X X X
X XXXXXXXXXXX X X X X X X
X             X X X X X X
XXXXXXXXXXXXX X X X XFX X